1 1 1 1 1 1 1 1 1 1 1 1 1
1 0 0 0 0 0 0 0 0 0 0 0 1
1 1 1 1 1 0 0 0 1 1 1 1 1
1 44 44 44 1 1 0 1 1 44 44 44 1
1 0 45 0 5 0 48 0 5 0 45 0 1
1 1 1 1 1 0 0 0 1 1 1 1 1
1 44 11 44 1 1 0 1 1 44 10 44 1
1 0 45 0 1 1 0 1 1 0 45 0 1
1 0 0 0 1 1 0 1 1 0 0 0 1
1 2 1 2 1 1 4 1 1 2 1 2 1
1 80 1 0 1 0 0 0 1 0 1 0 1
1 35 1 0 43 0 0 0 43 0 1 13 1
1 1 1 1 1 1 1 1 1 1 1 1 1