1 1 1 1 1 1 1 1 1 1 1 1 1
1 0 0 0 1 10 0 2 0 1 12 7 1
1 0 16 0 1 0 42 1 49 1 0 0 1
1 0 0 0 1 2 1 1 0 2 0 0 1
1 1 5 1 1 0 50 1 1 1 1 52 1
1 51 0 51 1 49 0 2 51 0 1 0 1
1 0 0 0 1 1 1 1 0 10 1 0 1
1 13 0 0 50 0 0 2 52 0 1 0 1
1 1 3 1 1 1 1 1 1 1 1 50 1
1 0 50 0 52 2 0 0 0 0 42 0 1
1 7 0 0 0 1 80 1 1 2 1 0 1
1 7 7 7 7 1 35 1 13 50 1 34 1
1 1 1 1 1 1 1 1 1 1 1 1 1