1 1 1 1 1 1 1 1 1 1 1 1 1
1 82 1 0 1 7 10 7 1 0 1 1 1
1 1 1 50 1 0 1 0 1 0 1 1 1
1 0 0 0 1 51 0 51 1 0 49 0 1
1 2 1 1 1 1 2 1 1 1 1 0 1
1 0 51 0 2 0 49 0 1 12 0 50 1
1 1 1 1 1 0 0 51 2 0 11 0 1
1 7 7 0 1 0 13 0 1 7 0 52 1
1 7 8 0 1 1 1 1 1 3 1 2 1
1 0 0 49 1 29 30 31 1 52 0 49 1
1 1 1 2 1 12 0 12 1 1 0 1 1
1 34 0 0 42 0 0 0 42 0 80 35 1
1 1 1 1 1 1 1 1 1 1 1 1 1