1 1 1 1 1 1 1 1 1 1 1 1 1
1 32 32 32 32 32 32 32 32 32 32 32 1
1 32 32 32 32 32 32 32 32 32 32 32 1
1 32 32 32 32 1 1 1 32 32 32 32 1
1 32 32 32 1 1 1 1 1 32 32 32 1
1 32 32 32 1 1 18 1 1 32 32 32 1
1 32 32 32 1 1 32 1 1 32 32 32 1
1 32 32 32 32 1 32 1 32 32 32 32 1
1 32 32 32 32 32 32 32 32 32 32 32 1
1 32 32 32 32 32 32 32 32 32 32 32 1
1 1 1 1 1 1 2 1 1 1 1 1 1
1 35 80 0 0 0 0 0 0 0 0 34 1
1 1 1 1 1 1 1 1 1 1 1 1 1