1 1 1 1 1 1 1 1 1 1 1 1 1
1 11 53 0 2 0 34 0 1 84 0 0 1
1 49 0 0 1 0 0 0 1 0 0 52 1
1 0 0 52 1 1 5 1 1 1 1 2 1
1 2 1 1 1 55 55 55 1 50 0 0 1
1 0 1 7 1 55 55 55 1 0 50 0 1
1 0 1 8 1 55 55 55 1 2 1 51 1
1 52 1 7 1 0 0 0 1 0 1 0 1
1 0 1 0 1 0 0 0 1 0 1 13 1
1 0 2 0 1 1 0 1 1 2 1 1 1
1 50 1 50 1 0 80 0 1 0 42 0 1
1 0 51 0 1 0 35 0 2 42 0 82 1
1 1 1 1 1 1 1 1 1 1 1 1 1