1 1 1 1 1 1 1 1 1 1 1 1 1
1 7 50 0 1 0 35 0 1 0 0 50 1
1 7 51 0 2 0 80 0 2 52 0 0 1
1 7 50 0 1 49 0 7 1 0 0 12 1
1 1 1 1 1 1 3 1 1 1 2 1 1
1 10 7 0 1 12 0 0 1 0 49 0 1
1 12 0 54 2 0 53 0 1 0 0 0 1
1 11 7 0 1 0 0 7 1 50 0 8 1
1 1 1 1 1 1 2 1 1 1 2 1 1
1 0 52 0 1 50 0 50 1 0 51 0 1
1 0 0 0 2 0 0 0 2 0 1 1 1
1 81 0 0 1 0 34 0 1 56 1 1 1
1 1 1 1 1 1 1 1 1 1 1 1 1