1 1 1 1 1 1 1 1 1 1 1 1 1
1 34 0 0 3 0 35 0 2 51 0 7 1
1 0 0 81 1 0 80 0 1 0 52 7 1
1 2 1 1 1 1 1 1 1 0 0 8 1
1 0 12 0 2 53 0 53 2 49 0 7 1
1 54 0 54 1 0 0 0 1 0 50 7 1
1 1 1 1 1 1 3 1 1 1 1 1 1
1 0 49 0 0 0 0 0 0 0 54 0 1
1 2 1 1 2 1 1 1 2 1 1 2 1
1 51 0 1 50 50 1 52 52 1 0 51 1
1 0 7 1 50 50 1 52 52 1 7 0 1
1 12 10 1 0 7 1 7 0 1 11 12 1
1 1 1 1 1 1 1 1 1 1 1 1 1