1 1 1 1 1 1 1 1 1 1 1 1 1
1 35 0 1 12 0 51 0 8 1 7 10 1
1 80 0 10 0 0 1 0 0 1 50 0 1
1 2 1 1 53 1 1 1 53 1 2 1 1
1 42 0 1 0 0 1 0 0 1 0 0 1
1 0 0 1 7 0 1 0 7 1 52 52 1
1 2 1 1 0 54 0 54 0 1 0 0 1
1 50 0 1 1 1 3 1 1 1 1 2 1
1 0 0 52 0 0 0 0 53 0 0 49 1
1 2 1 1 1 1 53 1 1 12 7 0 1
1 0 1 0 2 7 0 7 1 1 1 50 1
1 52 0 50 1 0 34 0 2 0 42 0 1
1 1 1 1 1 1 1 1 1 1 1 1 1