1 1 1 1 1 1 1 1 1 1 1 1 1
1 35 0 3 0 0 0 0 0 0 0 0 1
1 80 0 1 1 0 46 0 46 0 1 1 1
1 0 1 1 1 1 1 0 1 1 1 1 1
1 0 1 7 7 1 0 0 0 1 0 81 1
1 0 1 7 0 6 0 0 0 6 0 0 1
1 0 1 1 1 1 0 0 0 1 1 1 1
1 0 1 84 0 1 0 0 0 1 0 82 1
1 0 1 0 0 6 0 0 0 6 0 0 1
1 0 1 1 1 1 0 0 0 1 1 1 1
1 0 1 13 13 1 0 0 0 1 0 0 1
1 34 1 13 0 6 0 0 0 6 0 0 1
1 1 1 1 1 1 1 1 1 1 1 1 1