1 1 1 1 1 1 1 1 1 1 1 1 1
1 0 0 0 0 0 35 0 0 0 0 0 1
1 0 0 0 0 0 80 0 0 0 0 0 1
1 0 0 1 1 0 0 0 1 1 0 0 1
1 0 0 1 1 0 0 0 1 1 0 0 1
1 0 0 0 0 0 0 0 0 0 0 0 1
1 0 0 0 0 0 81 0 0 0 0 0 1
1 0 0 0 0 0 0 0 0 0 0 0 1
1 0 0 1 1 0 0 0 1 1 0 0 1
1 0 0 1 1 0 0 0 1 1 0 0 1
1 0 0 0 0 0 0 0 0 0 0 0 1
1 0 0 0 0 0 34 0 0 0 0 0 1
1 1 1 1 1 1 1 1 1 1 1 1 1