1 1 1 1 1 1 1 1 1 1 1 1 1
1 0 0 0 0 0 0 0 0 0 0 0 1
1 0 0 0 1 1 1 1 1 0 0 0 1
1 0 0 1 1 1 1 1 1 1 0 0 1
1 0 1 1 1 32 32 32 1 1 1 0 1
1 0 1 1 32 32 32 32 32 1 1 0 1
1 0 1 1 32 32 83 32 32 1 1 0 1
1 0 1 1 32 32 32 32 32 1 1 0 1
1 0 1 1 1 32 4 32 1 1 1 0 1
1 0 0 1 1 1 4 1 1 1 0 0 1
1 0 34 0 1 1 4 1 1 0 0 0 1
1 35 80 0 0 0 0 0 0 0 0 0 1
1 1 1 1 1 1 1 1 1 1 1 1 1