1 1 1 1 1 1 1 1 1 1 1 1 1
1 1 1 1 1 0 81 0 1 1 1 1 1
1 1 1 1 1 0 0 0 1 1 1 1 1
1 1 1 1 1 1 0 1 1 1 1 1 1
1 1 1 1 1 1 0 1 1 1 1 1 1
1 1 1 1 1 1 0 1 1 1 1 1 1
1 1 1 1 1 1 0 1 1 1 1 1 1
1 1 1 1 1 1 0 1 1 1 1 1 1
1 1 1 1 1 1 0 1 1 1 1 1 1
1 1 1 1 1 1 0 1 1 1 1 1 1
1 0 35 1 1 1 0 1 1 1 0 0 1
1 0 80 0 0 0 0 0 0 0 0 34 1
1 1 1 1 1 1 1 1 1 1 1 1 1