1 1 1 1 1 1 1 1 1 1 1 1 1
1 0 0 0 0 0 0 0 0 0 0 0 1
1 0 0 0 0 0 1 1 1 1 1 0 1
1 0 0 0 0 0 1 0 0 0 1 0 1
1 0 0 0 0 0 1 0 82 0 1 0 1
1 0 0 0 0 0 1 0 0 0 1 0 1
1 0 0 0 0 0 1 1 0 1 1 0 1
1 0 0 0 0 0 0 0 0 0 0 0 1
1 0 0 0 0 0 0 0 0 0 0 0 1
1 0 0 0 0 0 0 0 0 0 0 0 1
1 0 0 0 0 0 0 0 0 0 0 0 1
1 34 0 0 0 0 0 0 0 0 80 35 1
1 1 1 1 1 1 1 1 1 1 1 1 1