1 1 1 1 1 1 1 1 1 1 1 1 1
1 0 0 0 0 0 0 0 1 1 1 1 1
1 0 0 1 1 0 84 0 1 1 1 1 1
1 0 1 1 1 1 1 1 1 1 1 1 1
1 0 1 1 1 1 0 1 1 1 1 1 1
1 0 1 1 1 1 0 1 1 1 1 1 1
1 0 1 1 1 1 0 1 1 1 1 1 1
1 0 1 1 1 1 0 1 1 1 1 1 1
1 0 1 1 1 1 0 1 1 1 1 1 1
1 0 1 1 1 1 0 1 1 1 1 1 1
1 80 0 1 1 0 0 0 1 1 1 1 1
1 35 0 1 1 0 34 0 1 1 1 1 1
1 1 1 1 1 1 1 1 1 1 1 1 1