1 1 1 1 1 1 1 1 1 1 1 1 1
1 0 0 7 7 1 35 1 0 0 12 81 1
1 57 0 7 7 1 80 1 59 0 0 0 1
1 0 59 1 1 1 0 1 2 1 58 58 1
1 0 0 2 8 1 0 1 10 1 0 0 1
1 2 1 1 1 1 0 1 1 1 1 2 1
1 0 58 0 0 0 0 0 0 0 58 0 1
1 2 1 1 1 1 0 1 1 1 1 2 1
1 0 0 1 11 1 53 1 13 2 0 0 1
1 58 58 1 2 1 53 1 1 1 56 0 1
1 0 0 0 60 1 0 1 7 7 0 56 1
1 82 12 0 0 1 34 1 7 7 0 0 1
1 1 1 1 1 1 1 1 1 1 1 1 1