1 1 1 1 1 1 1 1 1 1 1 1 1
1 11 0 3 0 0 0 0 0 0 0 34 1
1 0 10 1 1 1 0 1 1 1 0 0 1
1 2 1 1 0 2 0 2 0 1 1 1 1
1 59 0 56 0 1 0 1 58 1 7 13 1
1 0 7 0 56 1 0 1 0 2 0 7 1
1 1 1 1 1 1 0 1 0 1 1 1 1
1 7 7 7 7 1 0 1 60 1 7 8 1
1 0 0 0 8 1 0 1 0 2 0 7 1
1 1 5 1 1 1 0 1 1 1 1 1 1
1 46 0 46 0 0 0 0 0 36 36 36 1
1 0 0 0 0 35 80 1 58 0 0 0 1
1 1 1 1 1 1 1 1 1 1 1 1 1