1 1 1 1 1 1 1 1 1 1 1 1 1
1 35 80 12 1 0 7 0 1 7 7 11 1
1 0 0 0 2 56 0 60 2 0 7 12 1
1 0 56 0 1 1 1 1 1 1 1 1 1
1 1 2 1 1 40 1 57 1 52 1 59 1
1 0 0 0 1 2 1 2 1 2 1 2 1
1 0 1 0 0 0 0 0 0 0 0 0 1
1 0 0 0 1 2 1 2 1 2 1 2 1
1 1 2 1 1 58 1 41 1 60 1 42 1
1 0 0 58 1 1 1 1 1 1 1 1 1
1 57 1 0 2 0 0 0 2 59 0 12 1
1 13 59 0 1 0 34 0 1 0 7 10 1
1 1 1 1 1 1 1 1 1 1 1 1 1