1 1 1 1 1 1 1 1 1 1 1 1 1
1 81 0 59 0 0 0 53 0 60 0 35 1
1 0 0 1 1 1 2 1 1 1 0 80 1
1 56 1 1 1 1 0 1 1 1 1 56 1
1 0 1 1 1 1 0 1 1 1 1 0 1
1 60 1 1 1 0 58 0 1 1 1 57 1
1 0 2 0 0 56 0 56 0 0 2 0 1
1 0 1 1 1 0 60 0 1 1 1 60 1
1 0 1 1 1 1 0 1 1 1 1 0 1
1 57 1 1 1 1 0 1 1 1 1 0 1
1 0 0 1 1 1 2 1 1 1 0 0 1
1 13 0 59 0 7 0 53 0 57 0 34 1
1 1 1 1 1 1 1 1 1 1 1 1 1