1 1 1 1 1 1 1 1 1 1 1 1 1
1 0 8 0 1 29 30 31 1 0 81 0 1
1 12 0 7 1 0 0 0 1 7 0 13 1
1 0 0 0 1 0 0 0 1 0 45 0 1
1 1 2 1 1 1 3 1 1 1 2 1 1
1 0 43 0 2 0 41 0 0 44 0 0 1
1 0 0 0 1 1 1 1 1 1 1 1 1
1 41 0 40 0 0 0 0 0 0 0 0 1
1 2 1 1 2 1 1 1 2 1 1 2 1
1 0 1 0 42 0 1 0 43 0 1 0 1
1 0 1 40 0 7 1 10 0 12 1 80 1
1 34 1 7 40 7 1 0 40 0 1 35 1
1 1 1 1 1 1 1 1 1 1 1 1 1