1 1 1 1 1 1 1 1 1 1 1 1 1
1 0 63 2 0 36 36 36 0 3 0 35 1
1 12 0 1 0 0 0 0 0 1 0 80 1
1 10 0 1 1 1 1 1 1 1 1 2 1
1 0 64 2 0 0 0 0 0 65 0 0 1
1 1 1 1 1 1 1 1 1 1 1 2 1
1 59 0 57 0 60 1 12 0 2 66 0 1
1 0 1 1 1 0 1 0 63 1 0 0 1
1 49 1 7 1 66 1 2 1 1 1 2 1
1 0 1 0 64 0 1 0 81 1 64 0 1
1 50 1 1 1 1 1 0 0 1 0 0 1
1 0 44 0 41 0 3 0 0 2 0 34 1
1 1 1 1 1 1 1 1 1 1 1 1 1