1 1 1 1 1 1 1 1 1 1 1 1 1
1 0 13 0 1 0 0 12 12 12 0 0 1
1 0 0 81 1 3 1 1 1 1 1 3 1
1 0 63 0 1 0 1 67 1 67 1 0 1
1 1 3 1 1 0 0 0 0 0 0 0 1
1 0 0 66 0 0 1 67 1 67 1 0 1
1 0 1 1 2 1 1 1 1 1 1 0 1
1 65 1 0 64 0 1 0 0 0 64 0 1
1 0 1 10 0 12 1 1 5 1 1 0 1
1 64 1 1 2 1 1 0 0 0 1 0 1
1 0 1 0 68 0 1 0 22 0 1 80 1
1 34 1 11 0 13 1 0 0 0 1 35 1
1 1 1 1 1 1 1 1 1 1 1 1 1