1 1 1 1 1 1 1 1 1 1 1 1 1
1 1 1 1 0 0 0 0 0 1 1 1 1
1 1 1 0 0 0 0 0 0 0 1 1 1
1 1 0 0 0 0 0 0 0 0 0 1 1
1 0 0 0 0 0 0 0 0 0 0 0 1
1 0 1 0 0 0 0 0 0 0 1 0 1
1 0 1 0 0 0 0 0 0 0 1 0 1
1 0 1 0 1 1 5 1 1 0 1 0 1
1 0 1 0 1 68 0 68 1 0 1 0 1
1 0 0 0 1 1 5 1 1 0 0 0 1
1 1 1 1 1 63 0 63 1 1 1 1 1
1 35 80 4 0 0 0 0 0 0 0 0 1
1 1 1 1 1 1 1 1 1 1 1 1 1