1 1 1 1 1 1 1 1 1 1 1 1 1
1 34 1 0 41 2 0 1 0 0 2 0 1
1 0 1 0 0 1 7 1 40 40 1 41 1
1 0 2 42 0 1 0 1 7 7 1 0 1
1 1 1 1 2 1 42 1 7 7 1 0 1
1 7 0 43 0 1 0 1 1 1 1 0 1
1 7 0 0 42 1 0 40 0 0 0 0 1
1 1 45 1 1 1 0 1 1 1 1 41 1
1 0 0 0 0 1 40 1 0 0 0 0 1
1 11 7 12 27 1 0 1 2 1 1 1 1
1 1 1 1 1 1 0 1 0 1 0 0 1
1 35 80 0 0 0 0 1 0 1 0 15 1
1 1 1 1 1 1 1 1 1 1 1 1 1