1 1 1 1 1 1 1 1 1 1 1 1 1
1 33 33 33 33 33 33 33 33 33 33 33 1
1 33 33 33 33 33 33 33 33 33 33 33 1
1 33 33 33 33 33 33 33 33 33 33 33 1
1 33 33 33 1 1 1 1 1 33 33 33 1
1 33 33 33 1 0 84 0 1 33 33 33 1
1 33 33 33 1 0 0 0 1 33 33 33 1
1 33 33 33 1 0 80 0 1 33 33 33 1
1 33 33 33 1 1 1 1 1 33 33 33 1
1 33 33 33 33 33 33 33 33 33 33 33 1
1 33 33 33 33 33 33 33 33 33 33 33 1
1 33 33 33 33 33 33 33 33 33 33 33 1
1 1 1 1 1 1 1 1 1 1 1 1 1