1 1 1 1 1 1 1 1 1 1 1 1 1
1 35 1 7 7 1 0 43 0 7 40 0 1
1 80 1 7 7 1 0 1 1 1 1 2 1
1 0 1 1 41 1 0 1 14 0 44 0 1
1 0 2 2 0 2 0 1 82 0 0 42 1
1 0 1 1 1 1 0 1 1 1 1 1 1
1 0 0 41 43 0 7 0 44 45 0 0 1
1 1 1 1 1 1 0 1 1 1 1 0 1
1 43 0 0 81 1 0 2 2 0 2 0 1
1 0 42 0 11 1 0 1 1 41 1 41 1
1 2 1 1 1 1 0 1 0 0 1 0 1
1 0 40 0 0 44 0 1 12 12 1 34 1
1 1 1 1 1 1 1 1 1 1 1 1 1