1 1 1 1 1 1 1 1 1 1 1 1 1
1 34 1 11 1 0 82 0 1 7 1 40 1
1 0 1 12 1 0 0 0 1 7 1 41 1
1 0 1 42 1 41 1 45 1 12 1 40 1
1 0 1 0 1 0 1 0 1 0 1 0 1
1 2 1 2 1 3 1 2 1 44 1 2 1
1 0 45 0 43 0 0 0 0 0 0 0 1
1 2 1 2 1 2 1 2 1 45 1 2 1
1 0 1 0 1 0 1 0 1 0 1 0 1
1 0 1 0 1 42 1 41 1 13 1 0 1
1 40 1 40 1 7 1 43 1 7 1 80 1
1 0 41 0 1 7 1 13 1 7 1 35 1
1 1 1 1 1 1 1 1 1 1 1 1 1