1 1 1 1 1 1 1 1 1 1 1 1 1
1 35 0 2 2 0 34 0 1 7 0 7 1
1 80 0 1 1 0 0 40 1 0 9 0 1
1 2 1 1 1 1 2 1 1 13 0 12 1
1 0 1 7 7 7 0 0 1 1 5 1 1
1 12 1 1 1 1 1 43 1 47 1 47 1
1 0 41 40 41 0 1 0 1 0 0 0 1
1 1 1 1 1 2 1 42 1 1 2 1 1
1 0 0 0 42 0 44 0 43 0 0 0 1
1 2 1 1 1 1 1 1 1 1 1 2 1
1 40 0 1 10 7 1 8 12 1 0 44 1
1 0 42 3 7 11 1 7 0 2 45 0 1
1 1 1 1 1 1 1 1 1 1 1 1 1