1 1 1 1 1 1 1 1 1 1 1 1 1
1 0 0 44 2 0 35 0 2 40 0 12 1
1 0 7 0 1 0 80 0 1 0 40 0 1
1 45 1 1 1 1 3 1 1 1 1 0 1
1 0 7 0 1 7 0 7 2 2 0 0 1
1 11 0 42 2 0 10 0 1 1 1 1 1
1 1 1 1 1 1 1 41 1 0 0 45 1
1 7 0 2 45 7 1 0 1 16 1 0 1
1 45 0 1 0 0 1 0 1 1 1 2 1
1 2 1 1 1 2 1 0 1 7 0 43 1
1 0 12 1 0 44 1 42 1 0 44 0 1
1 35 0 3 0 0 2 0 2 43 0 12 1
1 1 1 1 1 1 1 1 1 1 1 1 1