1 1 1 1 1 1 1 1 1 1 1 1 1
1 34 0 40 41 40 0 0 0 0 0 0 1
1 1 1 1 1 1 1 1 1 1 1 0 1
1 12 0 0 2 0 1 10 7 0 1 0 1
1 0 44 0 1 0 1 11 12 0 1 0 1
1 1 2 1 1 0 1 1 1 2 1 0 1
1 7 0 0 1 0 2 42 43 42 1 0 1
1 0 45 0 1 0 1 1 1 1 1 0 1
1 1 2 1 1 0 0 0 0 0 0 0 1
1 0 0 0 1 1 2 1 1 1 2 1 1
1 12 0 7 1 7 0 0 1 0 42 0 1
1 12 26 7 1 0 80 0 1 40 13 40 1
1 1 1 1 1 1 1 1 1 1 1 1 1