1 1 1 1 1 1 1 1 1 1 1 1 1
1 53 0 53 1 11 7 12 1 7 7 7 1
1 0 53 0 1 52 1 53 1 0 0 7 1
1 1 0 0 1 0 1 0 1 1 2 1 1
1 1 3 1 1 3 1 2 1 0 53 0 1
1 12 0 0 50 0 54 0 50 0 0 0 1
1 0 52 0 1 1 2 1 1 12 0 49 1
1 2 1 2 1 0 0 0 1 1 1 2 1
1 0 1 0 49 0 1 0 52 0 52 0 1
1 51 1 51 1 1 1 1 1 2 1 1 1
1 0 1 0 1 12 0 0 1 0 0 80 1
1 8 1 0 2 0 34 0 1 0 0 35 1
1 1 1 1 1 1 1 1 1 1 1 1 1