1 1 1 1 1 1 1 1 1 1 1 1 1
1 0 0 0 1 0 34 0 1 10 0 11 1
1 0 19 0 1 0 0 0 1 0 13 0 1
1 0 0 0 1 53 1 50 1 7 0 7 1
1 1 5 1 1 0 1 0 1 1 5 1 1
1 47 0 47 1 2 1 3 1 53 0 53 1
1 0 0 0 1 0 1 0 1 0 0 0 1
1 1 5 1 1 49 1 52 1 1 5 1 1
1 47 0 47 1 0 0 0 1 49 0 49 1
1 0 0 0 1 1 51 1 1 0 0 0 1
1 1 2 1 1 0 0 0 1 1 2 1 1
1 12 0 0 50 80 35 0 50 0 0 12 1
1 1 1 1 1 1 1 1 1 1 1 1 1