1 1 1 1 1 1 1 1 1 1 1 1 1
1 0 0 0 0 0 34 0 0 0 0 0 1
1 1 1 1 1 0 0 0 1 1 1 1 1
1 1 1 1 1 1 5 1 1 1 1 1 1
1 10 11 1 0 0 0 0 0 1 12 13 1
1 7 0 1 0 50 50 50 0 1 0 7 1
1 1 3 1 0 50 0 50 0 1 3 1 1
1 42 0 1 0 50 50 50 0 1 0 42 1
1 0 42 1 0 0 0 0 0 1 42 0 1
1 2 1 1 1 1 4 1 1 1 1 2 1
1 0 54 0 1 0 80 0 1 0 54 0 1
1 12 0 0 51 0 35 0 51 0 0 12 1
1 1 1 1 1 1 1 1 1 1 1 1 1