1 1 1 1 1 1 1 1 1 1 1 1 1
1 0 0 0 0 0 0 0 0 0 0 0 1
1 0 0 0 1 1 1 1 1 0 0 0 1
1 0 0 1 1 0 0 0 1 1 0 0 1
1 0 1 1 0 0 0 0 0 1 1 0 1
1 0 1 0 0 1 0 1 0 0 1 0 1
1 0 1 0 0 0 85 0 0 0 1 0 1
1 0 1 0 0 1 0 1 0 0 1 0 1
1 0 1 1 0 0 0 0 0 1 1 0 1
1 0 0 1 1 0 0 0 1 1 0 0 1
1 0 35 0 1 1 4 1 1 0 0 0 1
1 34 80 0 0 0 0 0 0 0 0 0 1
1 1 1 1 1 1 1 1 1 1 1 1 1