1 1 1 1 1 1 1 1 1 1 1 1 1
1 7 11 1 7 13 7 1 0 1 0 12 1
1 0 12 1 13 7 13 1 0 2 42 0 1
1 43 0 1 7 8 7 1 0 1 1 1 1
1 2 1 1 1 0 1 1 0 1 0 81 1
1 0 0 42 0 0 0 40 0 0 0 0 1
1 2 1 1 0 0 0 1 0 1 1 1 1
1 44 0 1 1 0 1 1 0 1 0 12 1
1 0 7 1 0 0 0 1 0 2 43 7 1
1 12 10 1 0 0 0 1 0 1 1 1 1
1 1 1 1 1 0 1 1 41 1 0 0 1
1 35 80 0 0 0 0 1 0 2 0 34 1
1 1 1 1 1 1 1 1 1 1 1 1 1