1 1 1 1 1 1 1 1 1 1 1 1 1
1 34 0 2 53 0 56 1 0 0 80 35 1
1 0 0 1 0 12 0 1 2 1 1 1 1
1 3 1 1 81 0 7 1 0 0 0 13 1
1 0 12 1 1 2 1 1 1 1 0 1 1
1 56 0 1 0 0 53 0 1 58 0 58 1
1 0 0 1 57 1 1 2 1 0 0 0 1
1 0 56 2 0 0 58 0 1 59 0 59 1
1 2 1 1 1 1 1 1 1 1 0 1 1
1 0 0 53 1 0 59 0 1 0 0 0 1
1 57 1 0 1 7 1 56 0 0 20 0 1
1 7 59 0 3 0 2 0 1 0 0 0 1
1 1 1 1 1 1 1 1 1 1 1 1 1