1 1 1 1 1 1 1 1 1 1 1 1 1
1 1 1 1 1 0 0 0 0 0 0 34 1
1 1 1 1 1 0 0 0 1 1 1 1 1
1 1 1 1 1 1 5 1 1 1 1 1 1
1 1 1 1 1 0 0 0 1 1 1 1 1
1 1 1 1 1 61 61 61 1 1 1 1 1
1 1 1 1 1 61 61 61 1 1 1 1 1
1 1 1 1 1 61 61 61 1 1 1 1 1
1 1 1 1 1 0 0 0 1 1 1 1 1
1 1 1 1 1 0 0 0 1 1 1 1 1
1 1 1 1 1 0 80 0 1 1 1 1 1
1 1 1 1 1 0 35 0 1 1 1 1 1
1 1 1 1 1 1 1 1 1 1 1 1 1