1 1 1 1 1 1 1 1 1 1 1 1 1
1 34 0 2 0 0 0 0 0 59 0 13 1
1 0 0 1 1 1 1 1 1 1 0 0 1
1 3 1 1 12 12 1 12 12 1 1 60 1
1 0 12 12 12 7 1 12 12 12 1 0 1
1 0 1 7 7 28 1 9 7 7 1 0 1
1 12 1 1 1 1 1 1 1 1 1 57 1
1 0 1 11 10 13 1 10 10 10 1 0 1
1 0 1 7 7 7 1 11 11 11 1 0 1
1 59 1 1 8 8 1 13 7 1 1 60 1
1 0 0 1 1 1 1 1 1 1 0 80 1
1 81 0 56 0 0 0 0 0 58 0 35 1
1 1 1 1 1 1 1 1 1 1 1 1 1