1 1 1 1 1 1 1 1 1 1 1 1 1
1 35 80 4 56 0 0 0 56 2 0 34 1
1 0 0 1 0 82 7 0 0 1 0 0 1
1 58 1 1 1 1 1 2 1 1 1 2 1
1 0 0 59 59 0 1 0 1 7 1 0 1
1 1 1 1 1 3 1 0 1 7 1 0 1
1 0 0 0 3 3 1 58 1 7 1 58 1
1 0 23 0 1 1 1 57 1 0 60 0 1
1 0 0 0 1 11 12 0 1 1 1 2 1
1 1 5 1 1 1 1 1 1 7 0 58 1
1 46 0 46 1 0 0 0 1 0 60 0 1
1 0 0 0 2 57 0 49 2 59 0 13 1
1 1 1 1 1 1 1 1 1 1 1 1 1