1 1 1 1 1 1 1 1 1 1 1 1 1
1 0 0 0 0 0 0 0 1 0 0 35 1
1 0 1 0 1 0 1 0 1 82 0 80 1
1 0 0 0 0 0 0 0 1 0 0 7 1
1 0 1 0 1 0 1 0 1 1 2 1 1
1 0 0 0 0 0 0 0 1 0 0 59 1
1 0 1 0 1 0 1 0 1 56 1 10 1
1 0 0 0 0 0 0 0 1 0 0 58 1
1 1 3 1 1 1 1 1 1 1 2 1 1
1 0 0 58 1 57 10 60 1 0 60 0 1
1 1 58 2 1 0 1 0 2 0 0 0 1
1 81 0 7 1 0 56 0 1 12 0 34 1
1 1 1 1 1 1 1 1 1 1 1 1 1