1 1 1 1 1 1 1 1 1 1 1 1 1
1 0 0 0 0 0 62 0 0 0 0 0 1
1 0 57 57 57 0 0 0 60 60 60 0 1
1 0 0 0 0 0 0 0 0 0 0 0 1
1 0 0 58 58 58 0 59 59 59 0 0 1
1 0 0 0 0 0 0 0 0 0 0 0 1
1 1 1 1 0 0 0 0 0 1 1 1 1
1 1 1 1 0 0 0 0 0 1 1 1 1
1 1 1 1 1 1 4 1 1 1 1 1 1
1 11 7 0 1 56 0 56 1 12 57 0 1
1 13 0 0 1 0 0 0 1 59 0 0 1
1 10 0 60 3 0 0 0 2 0 80 35 1
1 1 1 1 1 1 1 1 1 1 1 1 1