1 1 1 1 1 1 1 1 1 1 1 1 1
1 12 1 0 8 1 35 1 8 0 1 12 1
1 2 63 0 0 1 80 1 0 0 1 2 1
1 2 1 0 1 1 0 1 1 0 1 2 1
1 2 1 2 1 67 0 67 1 2 1 2 1
1 0 0 64 1 1 0 1 1 64 0 0 1
1 65 0 0 0 3 0 3 0 0 0 65 1
1 0 65 0 66 1 2 1 66 0 65 0 1
1 2 1 1 2 1 2 1 2 1 1 2 1
1 2 1 12 0 1 2 1 0 12 1 2 1
1 2 1 7 7 1 0 1 7 7 1 2 1
1 13 1 7 10 1 34 1 11 7 1 13 1
1 1 1 1 1 1 1 1 1 1 1 1 1