1 1 1 1 1 1 1 1 1 1 1 1 1
1 34 0 0 1 0 0 9 1 7 8 7 1
1 0 0 66 1 0 0 0 1 7 7 7 1
1 1 1 2 1 0 0 0 1 1 0 1 1
1 81 0 0 1 1 68 1 1 64 0 63 1
1 0 0 66 2 0 0 0 2 0 0 0 1
1 2 1 1 1 1 0 1 1 0 0 64 1
1 0 0 0 1 0 0 0 1 1 0 1 1
1 1 1 65 1 0 0 0 1 67 0 67 1
1 13 7 7 1 1 0 1 1 1 0 1 1
1 65 1 1 1 0 62 0 1 7 7 7 1
1 7 7 11 1 80 35 0 1 7 8 7 1
1 1 1 1 1 1 1 1 1 1 1 1 1