1 1 1 1 1 1 1 1 1 1 1 1 1
1 35 0 2 0 66 0 2 2 67 0 0 1
1 80 0 1 1 1 0 1 1 0 1 0 1
1 0 0 2 0 1 68 1 0 0 1 0 1
1 3 1 1 63 1 0 68 0 24 1 0 1
1 0 66 0 0 1 1 1 1 1 1 2 1
1 0 1 2 1 1 13 0 2 0 0 0 1
1 0 1 0 0 66 0 0 1 64 0 12 1
1 2 1 1 1 1 1 1 1 0 7 0 1
1 0 65 1 13 0 68 0 1 1 1 2 1
1 0 0 1 13 1 1 0 2 0 65 0 1
1 34 0 1 13 0 3 0 1 0 0 8 1
1 1 1 1 1 1 1 1 1 1 1 1 1