1 1 1 1 1 1 1 1 1 1 1 1 1
1 34 0 0 0 0 0 0 0 0 0 0 1
1 80 0 0 0 0 0 0 0 0 0 0 1
1 0 0 0 0 0 1 0 0 0 0 0 1
1 0 0 0 0 1 1 1 0 0 0 0 1
1 0 0 0 1 1 12 1 1 0 0 0 1
1 0 0 1 1 12 21 12 1 1 0 0 1
1 0 0 0 1 1 12 1 1 0 0 0 1
1 0 0 0 0 1 5 1 0 0 0 0 1
1 0 0 0 0 69 0 69 0 0 0 0 1
1 0 0 0 0 0 0 0 0 0 0 0 1
1 0 0 0 0 0 0 0 0 0 0 0 1
1 1 1 1 1 1 1 1 1 1 1 1 1