1 1 1 1 1 1 1 1 1 1 1 1 1
1 35 80 0 0 0 0 0 0 0 0 34 1
1 1 1 1 1 1 2 1 1 1 1 1 1
1 10 10 0 1 64 0 63 1 82 0 0 1
1 3 1 68 1 0 0 0 1 0 0 66 1
1 11 11 0 1 63 0 64 1 1 1 2 1
1 3 1 68 1 1 2 1 1 81 1 0 1
1 0 0 0 2 0 0 65 0 0 0 7 1
1 1 4 1 1 1 1 1 1 1 63 0 1
1 0 0 0 1 68 0 1 67 1 1 2 1
1 0 25 0 5 0 0 5 0 2 0 0 1
1 0 0 0 1 68 0 1 67 1 0 13 1
1 1 1 1 1 1 1 1 1 1 1 1 1