1 1 1 1 1 1 1 1 1 1 1 1 1
1 34 0 3 0 0 0 2 0 0 0 7 1
1 0 0 1 0 82 0 1 63 1 1 11 1
1 0 1 1 1 1 1 1 0 66 0 7 1
1 0 1 0 2 63 0 1 2 1 1 1 1
1 0 1 65 1 0 64 1 0 64 0 0 1
1 0 2 0 1 0 0 1 7 0 0 65 1
1 0 1 0 1 8 7 1 1 1 1 2 1
1 0 1 0 3 10 11 1 0 0 0 0 1
1 63 1 1 1 1 1 1 66 1 1 1 1
1 0 0 1 12 0 10 1 0 1 0 80 1
1 0 0 2 0 64 0 2 0 0 0 35 1
1 1 1 1 1 1 1 1 1 1 1 1 1